1 2 2 2 2 2 2 2 2 2 2 2 2 2 2 2 2 2 2 3 5 5 5 5 5 5 5 5 5 5 5 5 5 5 5 5 5 6 10 10 10 10 10 10 10 10 10 10 10 10 10 10 10 10 10 
2 4 4 4 4 4 4 3 4 3 4 3 3 3 3 3 3 3 3 4 7 7 7 8 8 7 8 7 8 6 6 7 7 6 6 7 8 8 14 14 14 14 14 14 14 13 14 13 14 13 14 14 14 16 10 
2 5 5 5 5 5 5 4 5 4 5 4 4 4 4 4 4 4 4 6 9 9 9 10 10 9 10 9 10 8 8 9 9 8 8 9 10 11 18 17 17 17 17 17 17 16 18 16 18 16 19 17 18 21 10 
4 10 10 10 10 10 10 9 10 9 10 9 9 9 9 9 8 9 9 12 18 18 18 20 21 18 20 18 20 16 17 18 18 17 16 18 20 22 36 34 34 34 34 34 34 31 36 32 36 32 38 34 36 42 14 
7 21 20 19 19 20 20 18 19 18 19 18 18 18 18 18 17 18 18 24 37 36 36 40 42 37 39 37 41 32 34 35 37 34 33 37 41 44 71 69 69 67 68 68 68 62 72 64 73 65 76 67 71 83 28 
9 23 22 21 21 22 22 21 21 21 21 21 21 21 21 21 21 21 21 28 43 42 42 44 45 43 43 43 45 40 41 41 43 41 41 43 45 54 83 83 83 81 82 82 82 79 84 80 85 81 86 81 83 89 62 
10 24 24 24 24 24 24 24 24 24 24 24 24 24 24 24 24 24 24 32 48 48 48 48 48 48 48 48 48 48 48 48 48 48 48 48 48 64 96 96 96 96 96 96 96 96 96 96 96 96 96 96 96 96 96 
